7 7 7 7 7 7 7 7 7 7 7 7 7 7 7 7 7 7 7 7 7 7 7 7 7 7 7 7 7 7 7 7 7 7 7 7 7 7 7 7 7 7 7 7 7 7 7 7 7 7
7 7 7 7 7 7 7 7 7 7 7 7 7 7 7 7 7 7 7 7 7 7 7 7 7 7 7 7 7 7 7 7 7 7 7 7 7 7 7 7 7 7 7 7 7 7 7 7 7 7
7 7 7 7 4 4 4 4 4 4 4 4 4 4 4 4 4 4 4 4 6 6 6 6 6 6 6 4 4 4 4 4 4 4 4 4 4 4 4 4 4 4 4 4 4 4 4 4 7 7
7 7 4 4 4 4 4 4 4 4 4 4 4 4 4 4 4 4 4 4 6 0 5 5 5 5 6 4 4 4 4 4 4 4 4 4 4 4 4 4 4 4 4 4 4 4 4 4 7 7
7 7 4 4 4 4 4 4 4 4 4 4 4 4 4 4 4 4 4 4 6 0 7 7 7 0 6 4 4 4 4 4 4 4 4 4 4 4 4 4 4 4 4 4 4 4 4 4 7 7
7 7 4 4 4 4 4 4 4 4 4 4 4 4 4 4 4 4 4 4 6 6 7 7 7 5 6 4 4 4 4 4 4 4 4 4 4 4 4 4 4 4 4 4 4 4 4 4 7 7
7 7 7 4 4 4 4 4 1 1 1 1 1 4 4 4 4 4 4 4 4 6 7 7 7 6 4 4 4 4 4 4 4 6 6 6 6 6 6 6 6 6 6 6 4 4 4 4 7 7
7 7 7 4 4 4 4 4 1 7 7 7 1 4 4 4 4 4 4 4 4 6 8 7 8 6 4 4 4 4 4 4 4 4 6 6 6 6 6 6 6 6 6 4 4 4 4 4 7 7
7 7 4 4 4 4 4 4 1 7 7 7 1 4 4 4 4 4 4 4 4 6 8 8 8 6 4 4 4 4 4 4 4 4 6 6 6 6 6 6 6 6 6 4 4 4 4 4 7 7
7 7 4 4 4 4 4 4 1 7 7 7 1 4 4 4 4 4 4 4 4 4 8 8 8 4 4 4 4 4 4 4 4 4 8 8 8 8 8 8 8 8 8 4 4 4 4 4 7 7
7 7 4 4 4 4 4 4 1 7 7 7 1 4 4 4 4 4 4 4 4 4 6 8 6 4 4 4 4 4 4 4 4 4 8 8 8 8 8 8 8 8 8 4 4 4 4 4 7 7
7 7 4 4 4 4 4 4 1 1 8 1 1 4 4 4 4 4 4 4 4 4 6 8 6 4 4 4 4 4 4 4 4 4 6 8 8 8 8 8 8 8 6 4 4 4 4 4 7 7
7 7 4 4 4 4 4 4 4 0 8 0 4 4 4 4 4 4 4 4 4 4 6 8 6 4 4 4 4 4 4 4 4 4 4 5 5 5 8 5 5 5 4 4 4 4 4 4 7 7
7 7 7 4 4 4 4 4 4 0 8 0 4 4 4 4 4 4 4 4 4 4 6 8 6 4 4 4 4 4 4 4 4 4 4 4 4 4 8 4 4 4 4 4 4 4 4 4 7 7
7 7 7 4 4 4 4 4 4 0 8 0 4 4 4 4 4 4 4 4 4 4 6 8 6 4 4 4 4 4 4 4 4 4 4 4 4 4 8 4 4 4 4 4 4 4 4 4 7 7
7 7 7 7 4 4 4 0 0 0 8 0 4 4 4 4 4 4 4 4 4 4 6 8 6 4 4 4 4 4 4 4 4 4 4 4 4 4 8 4 4 4 4 4 4 4 4 4 7 7
7 7 7 4 4 4 4 0 8 8 8 0 4 4 4 4 4 4 4 4 4 4 6 8 6 4 4 4 4 4 4 4 4 4 4 4 4 4 8 4 4 4 4 4 4 4 4 4 7 7
7 7 4 4 4 4 4 0 8 0 0 0 4 4 4 4 4 4 4 4 4 4 6 8 6 4 4 4 4 4 4 4 4 4 4 4 4 4 8 4 4 4 4 4 4 4 4 4 7 7
7 7 4 4 4 4 4 0 8 0 4 4 4 4 4 4 4 4 4 4 4 4 0 8 0 4 4 4 4 4 4 4 4 4 4 4 8 8 8 4 4 4 4 4 4 4 4 4 7 7
7 7 4 4 4 4 4 0 8 0 4 4 4 4 4 4 4 4 4 4 4 0 0 8 0 0 4 4 4 4 4 4 4 4 4 4 8 4 4 4 4 4 4 4 4 4 4 4 7 7
7 7 4 4 4 4 4 0 8 0 4 4 0 0 0 0 0 0 0 0 0 0 8 8 8 0 0 0 0 0 0 0 0 0 0 0 8 4 4 4 4 4 4 4 4 4 4 4 7 7
7 7 4 4 4 4 4 0 8 0 4 0 8 8 8 8 8 8 8 8 8 8 8 8 8 8 8 8 8 8 8 8 8 8 8 8 8 4 4 4 4 4 4 4 4 4 4 4 7 7
7 7 4 4 4 4 4 0 8 0 4 0 8 0 0 0 0 0 0 0 0 0 8 8 8 0 0 0 0 0 0 0 0 0 0 0 8 4 4 4 4 4 4 4 4 4 4 4 7 7
7 7 4 4 4 4 4 0 8 0 4 0 8 0 4 4 4 4 4 4 4 0 0 8 0 0 4 4 4 4 4 4 4 4 4 4 8 4 4 4 4 4 4 4 4 4 4 4 7 7
7 7 4 4 4 4 4 0 8 0 4 0 8 0 0 0 4 4 4 4 4 4 0 8 0 4 4 4 4 4 4 4 4 4 4 4 8 4 4 4 4 4 4 4 4 4 4 4 7 7
7 7 4 4 4 4 4 0 8 0 4 0 8 8 8 0 4 4 4 4 4 4 0 8 0 4 4 4 4 4 4 4 4 4 4 4 8 4 4 4 4 4 4 4 4 4 4 4 7 7
7 7 4 4 4 4 4 0 8 0 4 0 0 0 8 0 4 4 4 4 4 4 0 8 0 4 4 4 4 4 4 4 4 4 4 4 8 4 4 4 4 4 4 4 4 4 4 4 7 7
7 7 4 4 4 4 4 0 8 0 4 4 4 0 8 0 4 4 4 4 4 4 0 8 0 4 4 0 4 4 4 4 4 4 4 0 8 4 4 4 4 4 4 4 4 4 4 4 7 7
7 7 4 4 4 4 4 0 8 0 0 0 0 0 8 0 4 4 4 4 4 4 0 8 0 4 4 4 4 4 0 4 4 4 4 4 8 4 4 4 4 4 4 4 4 4 4 4 7 7
7 7 4 4 4 4 4 0 8 8 8 8 8 8 8 0 4 4 4 4 4 4 0 8 0 4 4 4 4 4 0 4 4 4 4 4 8 4 4 4 4 4 4 4 4 4 4 4 7 7
7 7 4 4 4 4 4 0 8 0 0 0 0 0 8 0 4 4 4 4 4 4 0 8 0 4 4 4 4 4 4 4 4 4 4 0 8 0 4 4 4 4 4 4 4 4 4 4 7 7
7 7 4 4 4 4 4 0 8 8 8 8 8 8 8 0 4 4 4 4 4 4 0 8 0 4 4 4 4 4 4 4 4 4 4 0 8 0 4 4 4 4 4 4 4 4 4 4 7 7
7 7 6 0 0 0 0 0 0 0 0 0 0 0 8 0 4 4 4 4 4 4 0 8 0 4 4 4 4 4 4 4 4 4 4 0 8 0 4 4 4 4 4 4 4 4 4 4 7 7
7 7 6 0 0 0 0 0 0 0 0 0 0 8 8 0 4 4 4 4 4 4 0 8 0 4 4 4 4 4 4 4 4 4 4 0 8 0 4 4 4 4 4 4 4 4 4 4 7 7
7 7 6 0 0 0 0 0 0 0 0 0 0 8 0 0 4 4 4 4 4 4 0 8 0 4 4 4 4 4 4 4 4 4 4 0 8 0 4 4 4 4 4 4 4 4 4 4 7 7
7 7 6 0 0 0 0 0 0 0 0 0 0 8 0 0 4 0 0 0 0 0 0 8 0 4 4 4 4 4 4 4 4 4 4 0 8 0 4 4 4 4 4 4 4 4 4 4 7 7
7 7 1 0 0 0 0 0 0 0 0 0 0 8 8 8 8 8 8 8 8 8 8 8 0 0 0 4 4 4 4 4 4 4 0 0 8 0 0 4 4 4 4 4 4 4 4 4 7 7
7 7 1 0 0 0 0 0 0 6 6 0 0 0 0 0 0 0 0 0 0 0 0 8 0 0 0 0 4 4 0 4 4 0 0 0 8 0 0 0 4 4 4 4 4 4 4 4 7 7
7 7 6 0 0 0 0 0 0 6 6 0 0 0 0 0 0 0 0 0 0 0 0 8 0 0 0 0 4 4 4 4 0 0 0 0 8 6 6 6 4 4 4 4 4 4 4 4 7 7
7 7 6 0 0 0 0 0 0 0 0 0 0 0 4 0 0 0 0 0 0 0 0 8 0 0 0 0 0 4 4 4 0 0 0 0 8 0 0 0 4 4 4 4 4 4 4 4 7 7
7 7 6 0 0 0 0 0 0 0 0 0 0 0 4 4 0 0 0 0 0 0 0 8 8 8 8 8 8 8 8 8 8 8 8 8 8 8 8 0 4 4 4 4 4 4 4 4 7 7
7 7 6 0 0 0 0 0 0 0 0 0 0 0 4 4 4 0 0 0 0 0 0 0 0 0 0 4 4 4 4 0 0 0 0 0 8 0 0 4 4 4 4 4 4 4 4 4 7 7
7 7 6 0 0 0 0 0 0 0 0 0 0 0 4 4 4 4 0 0 0 0 0 0 4 4 4 4 4 0 0 4 0 0 0 0 8 0 4 4 4 4 4 4 4 4 4 4 7 7
7 7 6 0 0 0 0 0 0 0 0 0 0 0 4 4 4 4 4 4 4 4 4 4 4 4 4 4 4 4 4 4 0 0 0 0 8 8 0 6 6 6 6 6 6 6 6 7 7 7
7 7 6 6 6 6 6 6 0 0 0 0 0 0 4 4 4 4 4 4 4 4 4 4 4 4 4 4 4 4 4 4 4 4 4 4 4 8 0 0 0 0 0 0 1 1 1 7 7 7
7 7 7 7 7 7 7 6 7 7 1 1 7 7 7 4 4 4 4 4 4 4 4 4 4 4 4 4 4 4 4 4 4 4 4 4 4 8 8 8 8 8 8 8 7 7 7 7 7 7
7 7 7 7 7 7 7 6 0 0 0 0 0 0 7 4 4 4 4 4 4 4 4 4 4 4 4 4 4 4 4 4 4 4 4 4 4 0 0 0 0 0 0 0 1 1 1 7 7 7
7 7 7 7 7 7 7 6 0 0 0 0 0 0 7 4 4 4 4 4 4 4 4 4 4 4 4 4 4 4 4 4 4 4 4 4 7 7 7 7 7 7 7 7 7 7 7 7 7 7
7 7 7 7 7 7 7 7 7 7 7 7 7 7 7 7 7 7 7 7 7 7 7 7 7 7 7 7 7 7 7 7 7 7 7 7 7 7 7 7 7 7 7 7 7 7 7 7 7 7
7 7 7 7 7 7 7 7 7 7 7 7 7 7 7 7 7 7 7 7 7 7 7 7 7 7 7 7 7 7 7 7 7 7 7 7 7 7 7 7 7 7 7 7 7 7 7 7 7 7


