0 0 0 0 0 0 0 0 0 0 0 0 0 0 0 0
0 0 0 0 0 0 0 0 0 0 0 0 0 0 0 0
0 0 4 4 4 6 0 0 0 6 5 5 5 5 0 0
0 5 5 4 6 6 0 0 0 6 6 5 4 4 5 0
0 4 4 5 6 0 0 0 0 0 6 5 4 5 4 0
0 5 5 5 6 0 0 2 0 0 6 5 5 4 5 0
0 4 5 5 6 0 2 2 2 0 6 4 5 4 4 0
0 4 4 5 6 0 0 2 0 0 6 5 4 4 4 0
0 5 4 5 6 6 0 2 0 6 6 4 5 5 5 0
0 0 5 4 4 6 0 2 0 6 5 4 5 5 0 0
0 0 0 0 0 0 0 0 0 0 0 0 0 0 0 0
0 0 0 0 0 0 0 0 0 0 0 0 0 0 0 0